200000000000000
101111101110110
101000000000000
101111101110110
101000000000000
101111101011110
100000000000010
111111101111111
100000000000001
110111101101101
000000000000000
111101101111111
000000000000000
111111101111111
000000000000003